NO ./sprites/tile_no.xpm
SO ./sprites/tile_so.xpm
WE ./sprites/tile_we.xpm
EA ./sprites/tile_ea.xpm

F 117,121,128
C 52,36,68


       1111111111111111111111111
       1000000000110000000000001
       1011000001110000000000001
       1001000000000000000000001
       1111111111111111111111101
        1111111111111111111111011
111111111011000001110000000000001111111111111
1000000000110000011101111D1D10000000000000001111111
111101111111110111000000100011111111111111001111111
11110111111111011101010000001            1001111111
11000000110101011100000010001            1001
10000000000000000000000010001            1001
10000000000000001101010010001            1001
11000001110101011111011110N11            1001
11110111 11101011101111011111            1001
11111111 1111111 1111111111111111111111111111
                              111111
